11111111111111111111111111111111
10000000000000011000000000000001
10000000000000011000000000000001
10011110011110011001111001111001
10000000000000000000000000000001
10000000000000000000000000000001
10011110011001111110011001111001